XXXXX
X F X
X X X
X X X
X   X
  X  
 XXX
  X  
X H X
XXXXX